WE ./images/mossy.xpm

SO ./images/redbrick.xpm

NO ./images/wood.xpm

EA ./images/greystone.xpm
C 178,102,254
F 254,204,208
        1111111111111111111111111
        1000000000110000000000001
        1011000001110000000000001
        1001000000000000000000001
111111111011000001110000000000001
100000000011000001110111100011111
11110111111111011100000010001
11110111111111011101010010001
110000001101010111000W0010001
1000000000000001100000010001
10000000000000001101010010001
110000011101010111101111000111
11110111 1110101 101111010001
11111111 1111111 11111111111