SO ./images/mossy.xpm

WE ./images/redbrick.xpm

EA ./images/wood.xpm

NO ./images/greystone.xpm

C 187,255,255
F 2,20,2
1111111
1111011
1111111
1111111
1111111
11111111111111111111111111111111111111111111
100000000000000000000000000000000000000000001
100001000000000000000000000000000000000000011
100000000000000000000000000000000000000000011
100000000000000000000000000000N00000000000001
100000000000000000000000000000000000000000001
101111111100000000000000000001111111000001111
110000011101011111101111010100001000001000011
1111011111110101110011101000100000000000000011
1111111111111111111111111111111111111111111111