WE ./images/mossy.xpm

SO ./images/redbrick.xpm

NO ./images/wood.xpm

EA ./images/greystone.xpm

C 187,255,255
F 255,255,255
111111111111111111111111111111111111111111111111111111111111
100000000000000110110110110111010000011100111101101100111111
100000001111000000100000101000001100010000000000000111111111
100010110001001000000001100000000000000110010000001111111111
110101100000011011001101011000000011001110011000011111111111
111100100110010011001110000100011001011000011100011111111111
111000000101100001010000011000000011010001001100111111111111
111000011101001101101001000100000000100101100001111111111111
110100110111001100000010010000101100110010000111111111111111
111100011111100110001100001100100000000001011111011111111111
111010110011111010101011010110100110001001101111111011111111
111011011101101010011101001010010000010011100011111111111101
111111110110001010100101011101010000000111001101111111111111
111010111010111001001011010010000000101111111111111111111111
111010010101100100001011001100000001100110100111111111101111
110100100100000101000000011100110111111111110111101111111111
100110100001010010001000000010110111010101110111111111111111
101101011111101110100110011001000011111011101111111111111111
101110000010000000010110010001100111100001101111111111110111
100000000000000000W00011010011000111010110011111100011111111
110100000000000000000001011000110010011100101111001100111111
111010000000000000101001011101011101111111011101101101111111
110010000000000101010110100111000100111111011101111100111111
111100100000101001000010000001100111011010111111100001111111
111000110000000110000000101110110011111111011110000101011111
110011000100100110000111111010000100110111111111011001101111
100000000001000111101011100001011001011110111111011101110111
110010000011010000000000000001100101010000000001100001111111
110011111111011111110011100000011011111111111000000000110111
111111111111111111111111111111111111111111111111111111111111