WE ./images/mossy.xpm

SO ./images/redbrick.xpm

NO ./images/wood.xpm

EA ./images/greystone.xpm

C 187,255,255
F 255,255,255
1111111
1111011
1111111
1111111
1111111
11111111111111111111111111111111111111111111
100000000000000000000000000000000000000000001
10000100W000000000000000000000100000000000011
100000000000000000000000000000000000000000011
100000000000000000000001000000000001000000001
10000000000000000000000000000000000000000001
101111111100000000000000010001111111000001111
110000011101011111101111010100001000001000011
1111011111110101010011101000100000000000000011
1111111111111111111111111111111111111111111111