NO ./images/textures/north/north.xpm

SO ./images/textures/south/south.xpm

WE ./images/textures/west/west.xpm

EA ./images/textures/east/east.xpm
C 255,10,23
F 2,20,2
        1111111111111111111111111
        1600900070110009009409091
        1000004000910004404404091
        1500000000020000440440491
111111111000004000910009009049091
188836000000004051111111111111111
17771000000000511160000916061
11111121111111111100000020001
11700000000100011100000010081
150040000 4000001040000010501
10000000400000000001010915051
11000001110000011111511110001
11117111111159511E11110100011
11111111111111111111111111111